BBBBBBBBBBBBBBBBBBBBBBBBBBBBBBBBBBBBBBBBBBBBB
B                                           B
BGGGGG                                      B
B    GRRGGGGG                             Z B
B           B                            WWWB
B           W       R                       B
B     W     G       G                       B
B   Y W     W       R   B    G              B
WWWWWWWWWWWWWWWWWWWWWWWWWWGGGBWWWWWWWWWWWWWWW
                          B  G XW
                          B  GWWW
                          WWWWW
                           

