                               WWWWWW 
                               WD   W    
                               WW   W    
                               W   ZW    
                               W   WW    
                               WY   W    
                               WW   W    
WWWWWWWWWWWWWWWWWWWW         WWW   WW    
WP                 W         W      W    
WWWRW              WW    WWWWW  W   W    
W   W               WWWWW          XW    
W 1 G                       RRRRGGBBW    
WWWWWWWWWWWWWWWWWWW        R        W    
                  WW                W    
                  WWW               W    
                  WWWWWWWWWWWWWWWWWWW    