                               WWWWWW
                               WD   W
                               WW   W
                               W   ZW
                               W   WW
                               WY   W
WWWWWWWWWWWWWWWWWWWW           WW   W
WP                 W         wWW   WW
WWWRW              WW        w      W
W   W               WWWWWWWWWW  W   W
W 1 G                              XW
WWWWWWWWWWWWWWWWWWW         RRRRGGBBW
                  WW                W
                  WWW               W
                  WWWWWWWWWWWWWWWWWWW