                               WWWWWW
                               WD   W
                               WW   W
                               W   ZW
                               W   WW
                               WY   W
WWWWWWWWWWWWWWWWWWWW           WW   W
WP                 W           W   WW
WWWRW              WW          W    W
W   W               WWWWWWWWWWWWW   W
W 1 G                              XW
WWWWWWWWWWWWWWWWWWW              RRRW
                  WW                W
                  WWW               W
                  WWWWWWWWWWWWWWWWWWW