BBBBBBBBBBBBBBBBBBBBBBBBBBBBBBBBBBBBBBBBBBBBB
B                                           B
BGGGGG                                      B
B    GRRGGGGG                               B
B           B                               B
B           W                               B
B     W     G       G                       B
B     W     W       R   B    G              B
WWWWWWWWWWWWWWWWWWWWWWWWWWWWWWWWWWWWWWWWWWWWW