BBBBBBBBBBBBBBBBBBBBBBBBBBBBBBBBBBBBBBBBBBBBB
B                                           B
BGGGGG                                      B                WWWWWWWWWWWWWWWWW
B    GRRGGGGG                             Z B                W        B      W
B           B                       WWWWWWWWB                W        B      W 
B           W       R                       BRRRRRRRRRRRGGGGGG       ZB      W
B     W     G       G                                              GGBB      W
B   Y W     W       R   B    G                                 G B           W
WWWWWWWWWWWWWWWWWWWWWWWWWWGGGBWWWWWWWWWWWWWWWWWWWWWWWWWWWWWWWWWWWWWWWWWWWWWWWW
                          B  G XW
                          B  GWWW
                          WWWWW
                           

