WWWWWWWWWWWWWWWWWWWWWWWWWWWWWWWWWWWWWWW
WX                                    W
W                                     W
W G                       Y           W
W    R                G    R          W
W                                     W
WRRGRRGRGRBBRRG  RGBRGRRGGGBBRGWWWWW  W
W                WZ                   W
W             GRGW               WWWWWW
W             RGRWRR           WWWWWWWW
W          BBBGGGW  GGGRRG    WWWWWWWWW
WD  P    RRGGRGBRW        1 WWWWWWWWWWW
WWWWWWWWWWWWWWWWWW        WWWWWWWWWWWWW
                 W        W
                 W        W
                 W        W
                 WWWWWWWWWW