

                          WWWWWWWWWWWWWWW
                          W        1   WW
                          W      WWWWW WW
                          W   W    1   WW
                          W      WWWWW WW
                          WR       1   WW
                          WB WWWWWWWWW WW
                          WG WY2    PW WWWWWW
                          WB WBWGB  WW 2   DW
                          WR WG    GWW WWWWWW
                          WG         W WW
                          WR    1    W WW
                          WB   2RRRR W WW
                          WB   2RRRR W WW
                          WW  WWWWWWWWRWW
                          W   WWWWWWWWRWWWW
                          W    BBBBRRRR 2XW
                          W    WWWWWWWWWWWW
                          WWWWWW


                                   
                                   
                                   
                                   
                                   
                                   
                                   