WWWWWWWWWWWWWWWWWW
WX     D        YW
W    WWWWW       W
W  2   Z   G  3  W
W  G          B  W
W     1  1       W
W1 3  1  1    2  W
WRGBRRRGGRRRRGGRGW   
W      BB        W   
W      RR        W   
W      GG        W   
W  P   RR        W   
WWWWWWWWWWWWWWWWWW   
                     
                     
                     
                     




