WWWWWWWWWWWWWWWWWWWWWWWWWWWWWWWWWWWWWWWWWWWWWWWWWWWWWWWW
W                                                      W
W       1         WWWWW    WWWWW    WWWWW    WWWWW     W
W                 W  XW    WY  W    WZ  W    W  DW     W
W       2         WW WW    WW WW    WW WW    WW WW     W
W                                                      W
W       3           R        G        B        W       W  
W  P                                                   W  
W                                                      W  
WWWWWWWWWWWWWWWWWWWWWWWWWWWWWWWWWWWWWWWWWWWWWWWWWWWWWWWW  



