WWW
WPWWWWWWWWWWWWWWWWWWWWWWWWWWWWWWWW
WRRWWWWWRRBRRWWR 1  WBBBBGW    XWW
WGGGGGGGGWWWGGGGWWGGGGGGGGW    RWW
WBBBWBBBBBRBBBWBBBRRRRRWBBB     WW
WWWWWWWWWWWWWWWWWWWWWWWWWWW      W
                          WWWWWWW
