WWWWWWWWWWWWWWWWWWWWWWWWWWWWWWWWWWWWWWWWWWWWWWWW
W  P           R      G            XB         DW
W              R      G            WB        WWW
W              R      G            WW       GGGWWW
W              R   Y  W     3      WW           ZW
WWWWWWWWWWWWWWWWWWWWWWWWWWWWWWWWWWWWWWWWWWWWWWWWWW