WWWWWWWWWWWWWWWWWW
WRRRRRRRZGGGGGRBDW
WRWWWWWWWWWWWWWWWW
WGGGGGGGGBBBBBBBBW
WWWWWWWWWRRRRRRRRW
WP      WWWBBBBBBW
WWRRRRRBBBWWWWWWGW
WWWWWWRBBBBWGGGWRW
     WRBWBWWRWRWBW
     WWWYGGGGWRXGW
       WWWWWWWWWWW