WWW
WPWWWWWWWWWWWWWWWWWWWWWWWWWWWWWWWW
WRRWWWWWRRBRRWWR 1  WBBBBGWGGGGXRW
WGGGGGGGGWWWGGGGWWGGGGGGGGW GGGRRW
WBBBWBBBBBGBBBWBBBRRRRRWBBBBBBBBRW
WWWWWWWWWWWWWWWWWWWWWWWWWWW     WW
                          WWWWWWW
