WWW
WPWWWWWWWWWWWWWWWWWWWWWWWWWWWWWWWW
WRRWWWWWRRBRRWWR 1  WBBBBGWGGGGXRW
WGGGGGGGGWWWGGGGWWGGGGGGGGWGGGGRRW
WBBBWBBBBBGBBBWBBBRRRRRWBBBBBBBBRW
WWWWWWWWWWWWWWWWWWWWWWWWWWWWWWWWWW


