WWW
WPWWWWWWWWWWWWWWWWWWWWWWWWWWWWWWWW
WRRWWWWWRRBRRWWR 1  WBBBBGW    XWW
WGGGGGGGGWWWGGGGWWGGGGGGGGW    RWW
WBBBWBBBBBRBBBWBBDRRRRRWBBB     WW
WWWWWWWWWWWWWWWWWWWWWWWWWWW      W
                          WWWWWWW
