WWWWWWWWWWWWWWWWWWWWWWWWWWWWWWWWWWWWWWW
WX                                    W
W                                     W
W G                                   W
W    R                G    R      Y   W
W                                     W
WRRGRRGRGRBBRRG  WWWW       BRGWWWWW  W
W                WZ                   W
W             GRGW               WWWWWW
W             RGRWRR           WWWWWWWW
W          BBBGGGW      GG    WWWWWWWWW
WD  P    RRGGRGBRW        1 WWWWWWWWWWW
WWWWWWWWWWWWWWWWWW        WWWWWWWWWWWWW
                 W        W
                 W        W
                 W    1 11W
                 WWWWWWWWWW