

                         WWWWWWWWWWWWWWWW
                         W      BBB1BBBRW
                         W  G   WWWWWWBRW
                         W  W   WBB1GGGRW
                         WB     WWWWWWBRW
                         WB     WGG1BBBRW
                         WG  WBBWWWWWW WW
                         W   WY2    PW WWWWWW
                         W   WBWGB  WW 2   DW
                         W   WG    GWW WWWWWW
                         W           W WW
                         W      1    W WW
                         W     2RRRR W WW
                         WZ    2BBBB W WW
                         WW   WWWWWWWWRWW
                          W   WWWWWWWWRWWWW
                          W    BBBBRRRR 2XW
                          W    WWWWWWWWWWWW
                          WWWWWW


                                   
                                   
                                   
                                   
                                   
                                   
                                   