                               WWWWWW 
                               WD   W    
                               WW   W    
                               W   ZW    
                               W   WW    
                               WY   W    
                               WW   W    
WWWWWWWWWWWWWWWWWWWW         WWW   WW    
WP                 W         W      W    
WWWRW              WW   WWWWWW  W   W    
W   W               WWWWW          XW    
W 1 G       2           W   RRRRGGBBW    
WWWWWWWWWWWWWWWWWWW     W  R        W    
                  WW                W    
                  WWW               W    
                  WWWWWWWWWWWWWWWWWWW    