WWWWWWW
W  P  W
W  R  W
W  X  W
W     W
W     W
W     W
W     W
W     W
W     W
W     W
W     W
W     W
W     W
W     W
W     W
WBR   W
WYB   W
W     W
W     W
W     W
W     W
W     W
W     W
W     W
W     W
W     W
W     W
W     W
W   GBW
W   RZW
W WWW W
W WDG W
WWWWWWW