WWWWWWWWWWWWWWWWWWWW
WX  W 2RBRBRBRBBBRRW
WG  W GGGGGGG   P RW
W  RW         RRRRRW
W     WWW    WWWWWWW
W      WWWD W      
WWWWWWWWWWWWW



