WWWWWWWWWWWWWWWWWW
WRRRRRRRZRRRRRRRRW
W                w
W                w
W                w
W                w
W                w
W                w
W  P             W
WWWWWWWWWWWWWWWWWW