                           
           WWW          
           WPW
           W W                       
           W W                       
           W WWWWWWWWWWWWWW          
           W  123         W          
           WWWWWW        ZW          
                W       WWW          
             WWWW       WWWWWW       
WWWWWWWW     W           W   W       
W   2  W     W  WWWWWWWW WWWWW
W  WWW WWWWWWW     RRRRW W
WW W            WR  2 GW W
 W W            WWGGG GW W    
 W                W    W W
 WWWRRRRRWWWWWWWWGW WWWW WWWWWWWWWW
   W         GXW  W WW            W
   W         WWW  W YW         BW W
   W         W    WWWW         BW W
   W         W                GGW W
   WWWWWWWWW W                WWW W
        W                     W W W
        W               G     W W WWW
     WWWW              GG     W W  DW
     W                  G     W WWWWW
     WBBW       BB      G     W 
     W  W        B      G     W
     WRRW        B      G     W
     W      G    B      G     W
     WWWWWWWWWWWWWWWWWWWWWWWWWW     


