WWW
WPWWWWWWWWWWWWWWWWWWWWWWWWWWWWWWWW
WRRWWWWWRRBRRWWR 1  WBBBBGW    XWW
WGGGGGGGGWWWGGGGWWGGGGGGGGW    RWW
WBBBWBBBBBGBBBWBBBRRRRRWBBB      W
WWWWWWWWWWWWWWWWWWWWWWWWWWW     WW
                          WWWWWWW
