WWWWWWWWWWWWWWWWWWWWWWWWWWWWWWWWWWWWWWWWWWWWWWWW
W  P           R      G            XB         DW
W              R      G            WB        WWW
W              R      G             W       GGGWWW
W              R   Y  W     3       W           ZW
WWWWWWWWWWWWWWWWWWWWWWWWWWWWWWWWWWWWWWWWWWWWWWWWWW