WWWWWWWWWWWWWWWWWWWWWWWWWWW
W  P R      G      B      W
W    R      G      B      W
W    R      G      W      W
W    R  Y   W  X  WW Z  D W
WWWWWWWWWWWWWWWWWWWWWWWWWWW