WWWWWWWWWWWWWWWWWWWWWWWWWWWWWWWWWWWWWWWWWWWWWWWWWWWWWWWWWWWWWWWWW         
WP                                                              W         
W                                                               W         
W                                                               W         
WW  WW                                                          W         
W    WWW                  X                    Y              D W         
W  W   WWWWWWW     RR     GG     BB     RR     GG     BB   WWWWWW         
WR                                                              W         
WW                                                              W         
WWWW                                                        Z   W         
WWWWWWWWWWWWWWWWWWWWWWWWWWWWWWWWWWWWWWWWWWWWWWWWWWWWWWWWWWWWWWWWW         
                                                                          
                                                                          