WWWWWWWWWWWWWWWWWWWWWWWWWWWWWWWWWWWWWWWWWWWWWWWW
W  P           R      G            XB         DW
W              R      G            WB        WWW
W              R      G           WWW       GGGWWW
W              R   Y  W     3     WWW           ZW
WWWWWWWWWWWWWWWWWWWWWWWWWWWWWWWWWWWWWWWWWWWWWWWWWW